*E*******
*       *
*   *****
*   *****
*      **
*       *
**    ***
*    S  *
*********