*E*******
* 		*
* 	*****
* 	*   *
* 	*****
* 		*
** S 	*
* 		*
*********